80 102
@@@@@@@@@@@@@@@@@@@@@@@@@@@@@@@@@@@@@@@@@@@@@@@@@@@@@@@@@@@@@@@@@@@@@@@@@@@@@@@@@@@@@@@@@@@@@@@@@@@@@@
@....................................................................................................@
@....................................................................................................@
@....................................................................................................@
@...@@.....@@.....@@.....@@.....@@.....@@.....@@.....@@.....@@.....@@.....@@.....@@.....@@.....@@....@
@...@@.....@@.....@@.....@@.....@@.....@@.....@@.....@@.....@@.....@@.....@@.....@@.....@@.....@@....@
@...@@.....@@.....@@.....@@.....@@.....@@.....@@.....@@.....@@.....@@.....@@.....@@.....@@.....@@....@
@...@@.....@@.....@@.....@@.....@@.....@@.....@@.....@@.....@@.....@@.....@@.....@@.....@@.....@@....@
@...@@.....@@.....@@.....@@.....@@.....@@.....@@.....@@.....@@.....@@.....@@.....@@.....@@.....@@....@
@...@@.....@@.....@@.....@@.....@@.....@@.....@@.....@@.....@@.....@@.....@@.....@@.....@@.....@@....@
@...@@.....@@.....@@.....@@.....@@.....@@.....@@.....@@.....@@.....@@.....@@.....@@.....@@.....@@....@
@...@@.....@@.....@@.....@@.....@@.....@@.....@@.....@@.....@@.....@@.....@@.....@@.....@@.....@@....@
@...@@.....@@.....@@.....@@.....@@.....@@.....@@.....@@.....@@.....@@.....@@.....@@.....@@.....@@....@
@...@@.....@@.....@@.....@@.....@@.....@@.....@@.....@@.....@@.....@@.....@@.....@@.....@@.....@@....@
@...@@.....@@.....@@.....@@.....@@.....@@.....@@.....@@.....@@.....@@.....@@.....@@.....@@.....@@....@
@...@@.....@@.....@@.....@@.....@@.....@@.....@@.....@@.....@@.....@@.....@@.....@@.....@@.....@@....@
@...@@.....@@.....@@.....@@.....@@.....@@.....@@.....@@.....@@.....@@.....@@.....@@.....@@.....@@....@
@...@@.....@@.....@@.....@@.....@@.....@@.....@@.....@@.....@@.....@@.....@@.....@@.....@@.....@@....@
@...@@.....@@.....@@.....@@.....@@.....@@.....@@.....@@.....@@.....@@.....@@.....@@.....@@.....@@....@
@...@@.....@@.....@@.....@@.....@@.....@@.....@@.....@@.....@@.....@@.....@@.....@@.....@@.....@@....@
@...@@.....@@.....@@.....@@.....@@.....@@.....@@.....@@.....@@.....@@.....@@.....@@.....@@.....@@....@
@...@@.....@@.....@@.....@@.....@@.....@@.....@@.....@@.....@@.....@@.....@@.....@@.....@@.....@@....@
@...@@.....@@.....@@.....@@.....@@.....@@.....@@.....@@.....@@.....@@.....@@.....@@.....@@.....@@....@
@...@@.....@@.....@@.....@@.....@@.....@@.....@@.....@@.....@@.....@@.....@@.....@@.....@@.....@@....@
@...@@.....@@.....@@.....@@.....@@.....@@.....@@.....@@.....@@.....@@.....@@.....@@.....@@.....@@....@
@...@@.....@@.....@@.....@@.....@@.....@@.....@@.....@@.....@@.....@@.....@@.....@@.....@@.....@@....@
@...@@.....@@.....@@.....@@.....@@.....@@.....@@.....@@.....@@.....@@.....@@.....@@.....@@.....@@....@
@...@@.....@@.....@@.....@@.....@@.....@@.....@@.....@@.....@@.....@@.....@@.....@@.....@@.....@@....@
@...@@.....@@.....@@.....@@.....@@.....@@.....@@.....@@.....@@.....@@.....@@.....@@.....@@.....@@....@
@...@@.....@@.....@@.....@@.....@@.....@@.....@@.....@@.....@@.....@@.....@@.....@@.....@@.....@@....@
@...@@.....@@.....@@.....@@.....@@.....@@.....@@.....@@.....@@.....@@.....@@.....@@.....@@.....@@....@
@...@@.....@@.....@@.....@@.....@@.....@@.....@@.....@@.....@@.....@@.....@@.....@@.....@@.....@@....@
@...@@.....@@.....@@.....@@.....@@.....@@.....@@.....@@.....@@.....@@.....@@.....@@.....@@.....@@....@
@...@@.....@@.....@@.....@@.....@@.....@@.....@@.....@@.....@@.....@@.....@@.....@@.....@@.....@@....@
@...@@.....@@.....@@.....@@.....@@.....@@.....@@.....@@.....@@.....@@.....@@.....@@.....@@.....@@....@
@...@@.....@@.....@@.....@@.....@@.....@@.....@@.....@@.....@@.....@@.....@@.....@@.....@@.....@@....@
@...@@.....@@.....@@.....@@.....@@.....@@.....@@.....@@.....@@.....@@.....@@.....@@.....@@.....@@....@
@...@@.....@@.....@@.....@@.....@@.....@@.....@@.....@@.....@@.....@@.....@@.....@@.....@@.....@@....@
@...@@.....@@.....@@.....@@.....@@.....@@.....@@.....@@.....@@.....@@.....@@.....@@.....@@.....@@....@
@...@@.....@@.....@@.....@@.....@@.....@@.....@@.....@@.....@@.....@@.....@@.....@@.....@@.....@@....@
@...@@.....@@.....@@.....@@.....@@.....@@.....@@.....@@.....@@.....@@.....@@.....@@.....@@.....@@....@
@...@@.....@@.....@@.....@@.....@@.....@@.....@@.....@@.....@@.....@@.....@@.....@@.....@@.....@@....@
@...@@.....@@.....@@.....@@.....@@.....@@.....@@.....@@.....@@.....@@.....@@.....@@.....@@.....@@....@
@...@@.....@@.....@@.....@@.....@@.....@@.....@@.....@@.....@@.....@@.....@@.....@@.....@@.....@@....@
@...@@.....@@.....@@.....@@.....@@.....@@.....@@.....@@.....@@.....@@.....@@.....@@.....@@.....@@....@
@...@@.....@@.....@@.....@@.....@@.....@@.....@@.....@@.....@@.....@@.....@@.....@@.....@@.....@@....@
@...@@.....@@.....@@.....@@.....@@.....@@.....@@.....@@.....@@.....@@.....@@.....@@.....@@.....@@....@
@...@@.....@@.....@@.....@@.....@@.....@@.....@@.....@@.....@@.....@@.....@@.....@@.....@@.....@@....@
@...@@.....@@.....@@.....@@.....@@.....@@.....@@.....@@.....@@.....@@.....@@.....@@.....@@.....@@....@
@...@@.....@@.....@@.....@@.....@@.....@@.....@@.....@@.....@@.....@@.....@@.....@@.....@@.....@@....@
@...@@.....@@.....@@.....@@.....@@.....@@.....@@.....@@.....@@.....@@.....@@.....@@.....@@.....@@....@
@...@@.....@@.....@@.....@@.....@@.....@@.....@@.....@@.....@@.....@@.....@@.....@@.....@@.....@@....@
@...@@.....@@.....@@.....@@.....@@.....@@.....@@.....@@.....@@.....@@.....@@.....@@.....@@.....@@....@
@...@@.....@@.....@@.....@@.....@@.....@@.....@@.....@@.....@@.....@@.....@@.....@@.....@@.....@@....@
@...@@.....@@.....@@.....@@.....@@.....@@.....@@.....@@.....@@.....@@.....@@.....@@.....@@.....@@....@
@...@@.....@@.....@@.....@@.....@@.....@@.....@@.....@@.....@@.....@@.....@@.....@@.....@@.....@@....@
@...@@.....@@.....@@.....@@.....@@.....@@.....@@.....@@.....@@.....@@.....@@.....@@.....@@.....@@....@
@...@@.....@@.....@@.....@@.....@@.....@@.....@@.....@@.....@@.....@@.....@@.....@@.....@@.....@@....@
@....................................................................................................@
@....................................................................................................@
@....................................................................................................@
@....................................................................................................@
@....................................................................................................@
@..........................@@@@.....@@@@.....@@@@.....@@@@.....@@@@.....@@@@.....@@@@.....@@@@.......@
@..........................@@@@.....@@@@.....@@@@.....@@@@.....@@@@.....@@@@.....@@@@.....@@@@.......@
@..........................@@@@.....@@@@.....@@@@.....@@@@.....@@@@.....@@@@.....@@@@.....@@@@.......@
@..........................@@@@.....@@@@.....@@@@.....@@@@.....@@@@.....@@@@.....@@@@.....@@@@.......@
@..........................@@@@.....@@@@.....@@@@.....@@@@.....@@@@.....@@@@.....@@@@.....@@@@.......@
@..........................@@@@.....@@@@.....@@@@.....@@@@.....@@@@.....@@@@.....@@@@.....@@@@.......@
@@@@@@@@@@@@@@@@@@@........@@@@.....@@@@.....@@@@.....@@@@.....@@@@.....@@@@.....@@@@.....@@@@.......@
@@@@@@@@@@@@@@@@@@@........@@@@.....@@@@.....@@@@.....@@@@.....@@@@.....@@@@.....@@@@.....@@@@.......@
@@@@@@@@@@@@@@@@@@@........@@@@.....@@@@.....@@@@.....@@@@.....@@@@.....@@@@.....@@@@.....@@@@.......@
@@@@@@@@@@@@@@@@@@@........@@@@.....@@@@.....@@@@.....@@@@.....@@@@.....@@@@.....@@@@.....@@@@.......@
@@@@@@@@@@@@@@@@@@@..................................................................................@
@@@@@@@@@@@@@@@@@@@..................................................................................@
@@@@@@@@@@@@@@@@@@@..................................................................................@
@@@@@@@@@@@@@@@@@@@..................................................................................@
@@@@@@@@@@@@@@@@@@@..................................................................................@
@@@@@@@@@@@@@@@@@@@.........OOOOOOOOOOOOOOO....................................IIIIIIIIIIIIIII.......@
@@@@@@@@@@@@@@@@@@@@@@@@@@@@OOOOOOOOOOOOOOO@@@@@@@@@@@@@@@@@@@@@@@@@@@@@@@@@@@@IIIIIIIIIIIIIII@@@@@@@
