80 102
@@@@@@@@@@@@@@@@@@@@@@@@@@@@@@@@@@@@@@@@@@@@@@@@@@@@@@@@@@@@@@@@@@@@@@@@@@@@@@@@@@@@@@@@@@@@@@@@@@@@@@
@....................................................................................................@
@....................................................................................................@
@....................................................................................................@
@...@@.....@@.....@@.....@@.....@@.....@@.....@@.....@@.....@@.....@@.....@@.....@@.....@@.....@@....@
@...@@.....@@.....@@.....@@.....@@.....@@.....@@.....@@.....@@.....@@.....@@.....@@.....@@.....@@....@
@...@@.....@@.....@@.....@@.....@@.....@@.....@@.....@@.....@@.....@@.....@@.....@@.....@@.....@@....@
@...@@.....@@.....@@.....@@.....@@.....@@.....@@.....@@.....@@.....@@.....@@.....@@.....@@.....@@....@
@...@@.....@@.....@@.....@@.....@@.....@@.....@@.....@@.....@@.....@@.....@@.....@@.....@@.....@@....@
@...@@.....@@.....@@.....@@.....@@.....@@.....@@.....@@.....@@.....@@.....@@.....@@.....@@.....@@....@
@...@@.....@@.....@@.....@@.....@@.....@@.....@@.....@@.....@@.....@@.....@@.....@@.....@@.....@@....@
@...@@.....@@.....@@.....@@.....@@.....@@.....@@.....@@.....@@.....@@.....@@.....@@.....@@.....@@....@
@...@@.....@@.....@@.....@@.....@@.....@@.....@@.....@@.....@@.....@@.....@@.....@@.....@@.....@@....@
@...@@.....@@.....@@.....@@.....@@.....@@.....@@.....@@.....@@.....@@.....@@.....@@.....@@.....@@....@
@...@@.....@@.....@@.....@@.....@@.....@@.....@@.....@@.....@@.....@@.....@@.....@@.....@@.....@@....@
@...@@.....@@.....@@.....@@.....@@.....@@.....@@.....@@.....@@.....@@.....@@.....@@.....@@.....@@....@
@...@@.....@@.....@@.....@@.....@@.....@@.....@@.....@@.....@@.....@@.....@@.....@@.....@@.....@@....@
@...@@.....@@.....@@.....@@.....@@.....@@.....@@.....@@.....@@.....@@.....@@.....@@.....@@.....@@....@
@...@@.....@@.....@@.....@@.....@@.....@@.....@@.....@@.....@@.....@@.....@@.....@@.....@@.....@@....@
@...@@.....@@.....@@.....@@.....@@.....@@.....@@.....@@.....@@.....@@.....@@.....@@.....@@.....@@....@
@...@@.....@@.....@@.....@@.....@@.....@@.....@@.....@@.....@@.....@@.....@@.....@@.....@@.....@@....@
@...@@.....@@.....@@.....@@.....@@.....@@.....@@.....@@.....@@.....@@.....@@.....@@.....@@.....@@....@
@...@@.....@@.....@@.....@@.....@@.....@@.....@@.....@@.....@@.....@@.....@@.....@@.....@@.....@@....@
@...@@.....@@.....@@.....@@.....@@.....@@.....@@.....@@.....@@.....@@.....@@.....@@.....@@.....@@....@
@...@@.....@@.....@@.....@@.....@@.....@@.....@@.....@@.....@@.....@@.....@@.....@@.....@@.....@@....@
@...@@.....@@.....@@.....@@.....@@.....@@.....@@.....@@.....@@.....@@.....@@.....@@.....@@.....@@....@
@...@@.....@@.....@@.....@@.....@@.....@@.....@@.....@@.....@@.....@@.....@@.....@@.....@@.....@@....@
@...@@.....@@.....@@.....@@.....@@.....@@.....@@.....@@.....@@.....@@.....@@.....@@.....@@.....@@....@
@...@@.....@@.....@@.....@@.....@@.....@@.....@@.....@@.....@@.....@@.....@@.....@@.....@@.....@@....@
@...@@.....@@.....@@.....@@.....@@.....@@.....@@.....@@.....@@.....@@.....@@.....@@.....@@.....@@....@
@...@@.....@@.....@@.....@@.....@@.....@@.....@@.....@@.....@@.....@@.....@@.....@@.....@@.....@@....@
@...@@.....@@.....@@.....@@.....@@.....@@.....@@.....@@.....@@.....@@.....@@.....@@.....@@.....@@....@
@...@@.....@@.....@@.....@@.....@@.....@@.....@@.....@@.....@@.....@@.....@@.....@@.....@@.....@@....@
@...@@.....@@.....@@.....@@.....@@.....@@.....@@.....@@.....@@.....@@.....@@.....@@.....@@.....@@....@
@...@@.....@@.....@@.....@@.....@@.....@@.....@@.....@@.....@@.....@@.....@@.....@@.....@@.....@@....@
@...@@.....@@.....@@.....@@.....@@.....@@.....@@.....@@.....@@.....@@.....@@.....@@.....@@.....@@....@
@...@@.....@@.....@@.....@@.....@@.....@@.....@@.....@@.....@@.....@@.....@@.....@@.....@@.....@@....@
@...@@.....@@.....@@.....@@.....@@.....@@.....@@.....@@.....@@.....@@.....@@.....@@.....@@.....@@....@
@...@@.....@@.....@@.....@@.....@@.....@@.....@@.....@@.....@@.....@@.....@@.....@@.....@@.....@@....@
@...@@.....@@.....@@.....@@.....@@.....@@.....@@.....@@.....@@.....@@.....@@.....@@.....@@.....@@....@
@...@@.....@@.....@@.....@@.....@@.....@@.....@@.....@@.....@@.....@@.....@@.....@@.....@@.....@@....@
@...@@.....@@.....@@.....@@.....@@.....@@.....@@.....@@.....@@.....@@.....@@.....@@.....@@.....@@....@
@...@@.....@@.....@@.....@@.....@@.....@@.....@@.....@@.....@@.....@@.....@@.....@@.....@@.....@@....@
@...@@.....@@.....@@.....@@.....@@.....@@.....@@.....@@.....@@.....@@.....@@.....@@.....@@.....@@....@
@...@@.....@@.....@@.....@@.....@@.....@@.....@@.....@@.....@@.....@@.....@@.....@@.....@@.....@@....@
@...@@.....@@.....@@.....@@.....@@.....@@.....@@.....@@.....@@.....@@.....@@.....@@.....@@.....@@....@
@...@@.....@@.....@@.....@@.....@@.....@@.....@@.....@@.....@@.....@@.....@@.....@@.....@@.....@@....@
@...@@.....@@.....@@.....@@.....@@.....@@.....@@.....@@.....@@.....@@.....@@.....@@.....@@.....@@....@
@...@@.....@@.....@@.....@@.....@@.....@@.....@@.....@@.....@@.....@@.....@@.....@@.....@@.....@@....@
@...@@.....@@.....@@.....@@.....@@.....@@.....@@.....@@.....@@.....@@.....@@.....@@.....@@.....@@....@
@...@@.....@@.....@@.....@@.....@@.....@@.....@@.....@@.....@@.....@@.....@@.....@@.....@@.....@@....@
@...@@.....@@.....@@.....@@.....@@.....@@.....@@.....@@.....@@.....@@.....@@.....@@.....@@.....@@....@
@...@@.....@@.....@@.....@@.....@@.....@@.....@@.....@@.....@@.....@@.....@@.....@@.....@@.....@@....@
@...@@.....@@.....@@.....@@.....@@.....@@.....@@.....@@.....@@.....@@.....@@.....@@.....@@.....@@....@
@...@@.....@@.....@@.....@@.....@@.....@@.....@@.....@@.....@@.....@@.....@@.....@@.....@@.....@@....@
@...@@.....@@.....@@.....@@.....@@.....@@.....@@.....@@.....@@.....@@.....@@.....@@.....@@.....@@....@
@...@@.....@@.....@@.....@@.....@@.....@@.....@@.....@@.....@@.....@@.....@@.....@@.....@@.....@@....@
@...@@.....@@.....@@.....@@.....@@.....@@.....@@.....@@.....@@.....@@.....@@.....@@.....@@.....@@....@
@....................................................................................................@
@....................................................................................................@
@....................................................................................................@
@....................................................................................................@
@....................................................................................................@
@..........................IIII.....IIII.....IIII.....IIII.....IIII.....IIII.....IIII.....IIII.......@
@..........................IIII.....IIII.....IIII.....IIII.....IIII.....IIII.....IIII.....IIII.......@
@..........................IIII.....IIII.....IIII.....IIII.....IIII.....IIII.....IIII.....IIII.......@
@..........................IIII.....IIII.....IIII.....IIII.....IIII.....IIII.....IIII.....IIII.......@
@..........................IIII.....IIII.....IIII.....IIII.....IIII.....IIII.....IIII.....IIII.......@
@..........................IIII.....IIII.....IIII.....IIII.....IIII.....IIII.....IIII.....IIII.......@
@RRRRRRRRRRRRRRRRRR........IIII.....IIII.....IIII.....IIII.....IIII.....IIII.....IIII.....IIII.......@
@RRRRRRRRRRRRRRRRRR........IIII.....IIII.....IIII.....IIII.....IIII.....IIII.....IIII.....IIII.......@
@RRRRRRRRRRRRRRRRRR........IIII.....IIII.....IIII.....IIII.....IIII.....IIII.....IIII.....IIII.......@
@RRRRRRRRRRRRRRRRRR........IIII.....IIII.....IIII.....IIII.....IIII.....IIII.....IIII.....IIII.......@
@RRRRRRRRRRRRRRRRRR..................................................................................@
@RRRRRRRRRRRRRRRRRR..................................................................................@
@RRRRRRRRRRRRRRRRRR..................................................................................@
@RRRRRRRRRRRRRRRRRR..................................................................................@
@RRRRRRRRRRRRRRRRRR..................................................................................@
@RRRRRRRRRRRRRRRRRR..................................................................................@
@@@@@@@@@@@@@@@@@@@@@@@@@@@@@@@@@@@@@@@@@@@@@@@@@@@@@@@@@@@@@@@@@@@@@@@@@@@@@@@@@@@@@@@@@@@@@@@@@@@@@@
