100 130
@@@@@@@@@@@@@@@@@@@@@@@@@@@@@@@@@@@@@@@@@@@@@@@@@@@@@@@@@@@@@@@@@@@@@@@@@@@@@@@@@@@@@@@@@@@@@@@@@@@@@@@@@@@@@@@@@@@@@@@@@@@@@@@@@@
@................................................................................................................................@
@................................................................................................................................@
@................................................................................................................................@
@....................................................................................................@@@@@@......................@
@.@@........@@@@@@@........@@@@@@@........@@@@@@@........@@@@@@@......@@@@@@@........@@@@@@@........@@@@@@@........@@@@@@@.......@
@.@@........@@@@@@@........@@@@@@@........@@@@@@@........@@@@@@@......@@@@@@@........@@@@@@@........@@@@@@@........@@@@@@@.......@
@.@@........@@@@@@@........@@@@@@@........@@@@@@@........@@@@@@@......@@@@@@@........@@@@@@@........@@@@@@@........@@@@@@@.......@
@.@@........@@@@@@@........@@@@@@@........@@@@@@@........@@@@@@@......@@@@@@@........@@@@@@@........@@@@@@@........@@@@@@@.......@
@.@@........@@@@@@@........@@@@@@@........@@@@@@@........@@@@@@@......@@@@@@@........@@@@@@@........@@@@@@@........@@@@@@@.......@
@.@@........@@@@@@@........@@@@@@@........@@@@@@@........@@@@@@@......@@@@@@@........@@@@@@@........@@@@@@@........@@@@@@@.......@
@.@@........@@@@@@@........@@@@@@@........@@@@@@@........@@@@@@@......@@@@@@@........@@@@@@@........@@@@@@@........@@@@@@@.......@
@.@@........@@@@@@@........@@@@@@@........@@@@@@@........@@@@@@@......@@@@@@@........@@@@@@@........@@@@@@@........@@@@@@@.......@
@.@@........@@@@@@@........@@@@@@@........@@@@@@@........@@@@@@@......@@@@@@@........@@@@@@@........@@@@@@@........@@@@@@@.......@
@.@@........@@@@@@@........@@@@@@@........@@@@@@@........@@@@@@@......@@@@@@@........@@@@@@@........@@@@@@@........@@@@@@@.......@
@.@@........@@@@@@@........@@@@@@@........@@@@@@@........@@@@@@@......@@@@@@@........@@@@@@@........@@@@@@@........@@@@@@@.......@
@.@@........@@@@@@@........@@@@@@@........@@@@@@@........@@@@@@@......@@@@@@@........@@@@@@@........@@@@@@@........@@@@@@@.......@
@.@@........@@@@@@@........@@@@@@@........@@@@@@@........@@@@@@@......@@@@@@@........@@@@@@@........@@@@@@@........@@@@@@@.......@
@.@@........@@@@@@@........@@@@@@@........@@@@@@@........@@@@@@@......@@@@@@@........@@@@@@@........@@@@@@@........@@@@@@@.......@
@.@@........@@@@@@@........@@@@@@@........@@@@@@@........@@@@@@@......@@@@@@@........@@@@@@@........@@@@@@@........@@@@@@@.......@
@.@@........@@@@@@@........@@@@@@@........@@@@@@@........@@@@@@@......@@@@@@@........@@@@@@@........@@@@@@@........@@@@@@@.......@
@.@@........@@@@@@@........@@@@@@@........@@@@@@@........@@@@@@@......@@@@@@@........@@@@@@@........@@@@@@@........@@@@@@@.......@
@.@@........@@@@@@@........@@@@@@@........@@@@@@@........@@@@@@@......@@@@@@@........@@@@@@@........@@@@@@@........@@@@@@@.......@
@.@@........@@@@@@@........@@@@@@@........@@@@@@@........@@@@@@@......@@@@@@@........@@@@@@@........@@@@@@@........@@@@@@@.......@
@.@@........@@@@@@@........@@@@@@@........@@@@@@@........@@@@@@@......@@@@@@@........@@@@@@@........@@@@@@@........@@@@@@@.......@
@.@@........@@@@@@@........@@@@@@@........@@@@@@@........@@@@@@@......@@@@@@@........@@@@@@@........@@@@@@@........@@@@@@@.......@
@.@@........@@@@@@@........@@@@@@@........@@@@@@@........@@@@@@@......@@@@@@@........@@@@@@@........@@@@@@@........@@@@@@@.......@
@.@@........@@@@@@@........@@@@@@@........@@@@@@@........@@@@@@@......@@@@@@@........@@@@@@@........@@@@@@@........@@@@@@@.......@
@.@@........@@@@@@@........@@@@@@@........@@@@@@@........@@@@@@@......@@@@@@@........@@@@@@@........@@@@@@@........@@@@@@@.......@
@.@@........@@@@@@@........@@@@@@@........@@@@@@@........@@@@@@@......@@@@@@@........@@@@@@@........@@@@@@@........@@@@@@@.......@
@.@@........@@@@@@@........@@@@@@@........@@@@@@@........@@@@@@@......@@@@@@@........@@@@@@@........@@@@@@@........@@@@@@@.......@
@.@@........@@@@@@@........@@@@@@@........@@@@@@@........@@@@@@@......@@@@@@@........@@@@@@@........@@@@@@@........@@@@@@@.......@
@.@@........@@@@@@@........@@@@@@@........@@@@@@@........@@@@@@@......@@@@@@@........@@@@@@@........@@@@@@@........@@@@@@@.......@
@.@@........@@@@@@@........@@@@@@@........@@@@@@@........@@@@@@@......@@@@@@@........@@@@@@@........@@@@@@@........@@@@@@@.......@
@.@@........@@@@@@@........@@@@@@@........@@@@@@@........@@@@@@@......@@@@@@@........@@@@@@@........@@@@@@@........@@@@@@@.......@
@.@@........@@@@@@@........@@@@@@@........@@@@@@@........@@@@@@@......@@@@@@@........@@@@@@@........@@@@@@@........@@@@@@@.......@
@.@@........@@@@@@@........@@@@@@@........@@@@@@@........@@@@@@@......@@@@@@@........@@@@@@@........@@@@@@@........@@@@@@@.......@
@.@@........@@@@@@@........@@@@@@@........@@@@@@@........@@@@@@@......@@@@@@@........@@@@@@@........@@@@@@@........@@@@@@@.......@
@.@@........@@@@@@@........@@@@@@@........@@@@@@@........@@@@@@@......@@@@@@@........@@@@@@@........@@@@@@@........@@@@@@@.......@
@.@@........@@@@@@@........@@@@@@@........@@@@@@@........@@@@@@@......@@@@@@@........@@@@@@@........@@@@@@@........@@@@@@@.......@
@.@@........@@@@@@@........@@@@@@@........@@@@@@@........@@@@@@@......@@@@@@@........@@@@@@@........@@@@@@@........@@@@@@@.......@
@.@@........@@@@@@@........@@@@@@@........@@@@@@@........@@@@@@@......@@@@@@@........@@@@@@@........@@@@@@@........@@@@@@@.......@
@.@@........@@@@@@@........@@@@@@@........@@@@@@@........@@@@@@@......@@@@@@@........@@@@@@@........@@@@@@@........@@@@@@@.......@
@.@@........@@@@@@@........@@@@@@@........@@@@@@@........@@@@@@@......@@@@@@@........@@@@@@@........@@@@@@@........@@@@@@@.......@
@.@@........@@@@@@@........@@@@@@@........@@@@@@@........@@@@@@@......@@@@@@@........@@@@@@@........@@@@@@@........@@@@@@@.......@
@.@@........@@@@@@@........@@@@@@@........@@@@@@@........@@@@@@@......@@@@@@@........@@@@@@@........@@@@@@@........@@@@@@@.......@
@.@@........@@@@@@@........@@@@@@@........@@@@@@@........@@@@@@@......@@@@@@@........@@@@@@@........@@@@@@@........@@@@@@@.......@
@.@@........@@@@@@@........@@@@@@@........@@@@@@@........@@@@@@@......@@@@@@@........@@@@@@@........@@@@@@@........@@@@@@@.......@
@.@@........@@@@@@@........@@@@@@@........@@@@@@@........@@@@@@@......@@@@@@@........@@@@@@@........@@@@@@@........@@@@@@@.......@
@.@@........@@@@@@@........@@@@@@@........@@@@@@@........@@@@@@@......@@@@@@@........@@@@@@@........@@@@@@@........@@@@@@@.......@
@.@@........@@@@@@@........@@@@@@@........@@@@@@@........@@@@@@@......@@@@@@@........@@@@@@@........@@@@@@@........@@@@@@@.......@
@.@@........@@@@@@@........@@@@@@@........@@@@@@@........@@@@@@@......@@@@@@@........@@@@@@@........@@@@@@@........@@@@@@@.......@
@.@@........@@@@@@@........@@@@@@@........@@@@@@@........@@@@@@@......@@@@@@@........@@@@@@@........@@@@@@@........@@@@@@@.......@
@.........................................@@@@@@@........@@@@@@@......@@@@@@@........@@@@@@@........@@@@@@@........@@@@@@@.......@
@.........................................@@@@@@@........@@@@@@@......@@@@@@@........@@@@@@@........@@@@@@@........@@@@@@@.......@
@.........................................@@@@@@@........@@@@@@@......@@@@@@@........@@@@@@@........@@@@@@@........@@@@@@@.......@
@.........................................@@@@@@@......................@@@@@@........@@@@@@@........@@@@@@@.........@@@@@@.......@
@................................................................................................................................@
@................................................................................................................................@
@................................................................................................................................@
@................................................................................................................................@
@................................................................................................................................@
@................................................................................................................................@
@................................................................................................................................@
@................................................................................................................................@
@................................................................................................................................@
@................................................................................................................................@
@................................................................................................................................@
@................................................................................................................................@
@................................................................................................................................@
@.........................................@@@.@@@........@@@.@@@......@@@.@@@........@@@..@@........@@@..@@......................@
@.........................................@@@.@@@........@@@.@@@......@@@.@@@........@@@..@@........@@@..@@......................@
@.........................................@@@.@@@........@@@.@@@......@@@.@@@........@@@..@@........@@@..@@......................@
@.........................................@@@.@@@........@@@.@@@......@@@.@@@........@@@..@@........@@@..@@......................@
@.........................................@@@.@@@........@@@.@@@......@@@.@@@........@@@..@@........@@@..@@......................@
@.........................................@@@.@@@........@@@.@@@......@@@.@@@........@@@..@@........@@@..@@....................@.@
@.........................................@@@.@@@........@@@.@@@......@@@.@@@........@@@..@@........@@@..@@....................@.@
@.........................................@@@.@@@........@@@.@@@......@@@.@@@........@@@..@@........@@@..@@....................@.@
@.........................................@@@.@@@........@@@.@@@......@@@.@@@........@@@..@@........@@@..@@....................@.@
@.........................................@@@.@@@........@@@.@@@......@@@.@@@........@@@..@@........@@@..@@....................@.@
@.........................................@@@.@@@........@@@.@@@......@@@.@@@........@@@..@@........@@@..@@....................@.@
@.........................................@@@.@@@........@@@.@@@......@@@.@@@........@@@..@@........@@@..@@....................@.@
@.........................................@@@.@@@........@@@.@@@......@@@.@@@........@@@..@@........@@@..@@....................@.@
@.........................................@@@.@@@........@@@.@@@......@@@.@@@........@@@..@@........@@@..@@....................@.@
@.........................................@@@.@@@........@@@.@@@......@@@.@@@........@@@..@@........@@@..@@....................@.@
@.........................................@@@.@@@........@@@.@@@......@@@.@@@........@@@..@@........@@@..@@....................@.@
@..............................................................................................................................@.@
@..............................................................................................................................@.@
@..............................................................................................................................@.@
@..............................................................................................................................@.@
@..............................................................................................................................@.@
@..............................................................................................................................@.@
@..............................................................................................................................@.@
@..............................................................................................................................@.@
@..............................................................................................................................@.@
@..............................................................................................................................@.@
@..............................................................................................................................@.@
@..............................................................................................................................@.@
@................................................................................................................................@
@@@@@@@@@@@@@@@@@@@@@@@@@@@@@@@@@@@@@@@@@@@@@@@@@@@@@@@@@@@@@@@@@@@@@@@@@@@@@@@@@@@@@@@@@@@@@@@@@@@@@@@@@@@@@@@@@@@@@@@@@@@@@@@@@@
