80 102
@@@@@@@@@@@@@@@@@@@@@@@@@@@@@@@@@@@@@@@@@@@@@@@@@@@@@@@@@@@@@@@@@@@@@@@@@@@@@@@@@@@@@@@@@@@@@@@@@@@@@@
@....................................................................................................@
@....................................................................................................@
@....................................................................................................@
@....................................................................................................@
@....................................................................................................@
@....................................................................................................@
@....................................................................................................@
@....................................................................................................@
@....................................................................................................@
@....@.....@.....@.....@.....@.....@.....@.....@.....@.....@.....@.....@.....@.....@.....@.....@.....@
@....@.....@.....@.....@.....@.....@.....@.....@.....@.....@.....@.....@.....@.....@.....@.....@.....@
@....@.....@.....@.....@.....@.....@.....@.....@.....@.....@.....@.....@.....@.....@.....@.....@.....@
@....@.....@.....@.....@.....@.....@.....@.....@.....@.....@.....@.....@.....@.....@.....@.....@.....@
@....@.....@.....@.....@.....@.....@.....@.....@.....@.....@.....@.....@.....@.....@.....@.....@.....@
@....@.....@.....@.....@.....@.....@.....@.....@.....@.....@.....@.....@.....@.....@.....@.....@.....@
@....@.....@.....@.....@.....@.....@.....@.....@.....@.....@.....@.....@.....@.....@.....@.....@.....@
@....@.....@.....@.....@.....@.....@.....@.....@.....@.....@.....@.....@.....@.....@.....@.....@.....@
@....@.....@.....@.....@.....@.....@.....@.....@.....@.....@.....@.....@.....@.....@.....@.....@.....@
@....@.....@.....@.....@.....@.....@.....@.....@.....@.....@.....@.....@.....@.....@.....@.....@.....@
@....@.....@.....@.....@.....@.....@.....@.....@.....@.....@.....@.....@.....@.....@.....@.....@.....@
@....@.....@.....@.....@.....@.....@.....@.....@.....@.....@.....@.....@.....@.....@.....@.....@.....@
@....@.....@.....@.....@.....@.....@.....@.....@.....@.....@.....@.....@.....@.....@.....@.....@.....@
@....@.....@.....@.....@.....@.....@.....@.....@.....@.....@.....@.....@.....@.....@.....@.....@.....@
@....@.....@.....@.....@.....@.....@.....@.....@.....@.....@.....@.....@.....@.....@.....@.....@.....@
@....@.....@.....@.....@.....@.....@.....@.....@.....@.....@.....@.....@.....@.....@.....@.....@.....@
@....@.....@.....@.....@.....@.....@.....@.....@.....@.....@.....@.....@.....@.....@.....@.....@.....@
@....@.....@.....@.....@.....@.....@.....@.....@.....@.....@.....@.....@.....@.....@.....@.....@.....@
@....@.....@.....@.....@.....@.....@.....@.....@.....@.....@.....@.....@.....@.....@.....@.....@.....@
@....@.....@.....@.....@.....@.....@.....@.....@.....@.....@.....@.....@.....@.....@.....@.....@.....@
@....@.....@.....@.....@.....@.....@.....@.....@.....@.....@.....@.....@.....@.....@.....@.....@.....@
@....@.....@.....@.....@.....@.....@.....@.....@.....@.....@.....@.....@.....@.....@.....@.....@.....@
@....@.....@.....@.....@.....@.....@.....@.....@.....@.....@.....@.....@.....@.....@.....@.....@.....@
@....@.....@.....@.....@.....@.....@.....@.....@.....@.....@.....@.....@.....@.....@.....@.....@.....@
@....@.....@.....@.....@.....@.....@.....@.....@.....@.....@.....@.....@.....@.....@.....@.....@.....@
@....@.....@.....@.....@.....@.....@.....@.....@.....@.....@.....@.....@.....@.....@.....@.....@.....@
@....@.....@.....@.....@.....@.....@.....@.....@.....@.....@.....@.....@.....@.....@.....@.....@.....@
@....@.....@.....@.....@.....@.....@.....@.....@.....@.....@.....@.....@.....@.....@.....@.....@.....@
@....@.....@.....@.....@.....@.....@.....@.....@.....@.....@.....@.....@.....@.....@.....@.....@.....@
@....@.....@.....@.....@.....@.....@.....@.....@.....@.....@.....@.....@.....@.....@.....@.....@.....@
@....@.....@.....@.....@.....@.....@.....@.....@.....@.....@.....@.....@.....@.....@.....@.....@.....@
@....@.....@.....@.....@.....@.....@.....@.....@.....@.....@.....@.....@.....@.....@.....@.....@.....@
@....@.....@.....@.....@.....@.....@.....@.....@.....@.....@.....@.....@.....@.....@.....@.....@.....@
@....@.....@.....@.....@.....@.....@.....@.....@.....@.....@.....@.....@.....@.....@.....@.....@.....@
@....@.....@.....@.....@.....@.....@.....@.....@.....@.....@.....@.....@.....@.....@.....@.....@.....@
@....@.....@.....@.....@.....@.....@.....@.....@.....@.....@.....@.....@.....@.....@.....@.....@.....@
@....@.....@.....@.....@.....@.....@.....@.....@.....@.....@.....@.....@.....@.....@.....@.....@.....@
@....@.....@.....@.....@.....@.....@.....@.....@.....@.....@.....@.....@.....@.....@.....@.....@.....@
@....@.....@.....@.....@.....@.....@.....@.....@.....@.....@.....@.....@.....@.....@.....@.....@.....@
@....@.....@.....@.....@.....@.....@.....@.....@.....@.....@.....@.....@.....@.....@.....@.....@.....@
@....@.....@.....@.....@.....@.....@.....@.....@.....@.....@.....@.....@.....@.....@.....@.....@.....@
@....@.....@.....@.....@.....@.....@.....@.....@.....@.....@.....@.....@.....@.....@.....@.....@.....@
@....@.....@.....@.....@.....@.....@.....@.....@.....@.....@.....@.....@.....@.....@.....@.....@.....@
@....@.....@.....@.....@.....@.....@.....@.....@.....@.....@.....@.....@.....@.....@.....@.....@.....@
@....@.....@.....@.....@.....@.....@.....@.....@.....@.....@.....@.....@.....@.....@.....@.....@.....@
@....@.....@.....@.....@.....@.....@.....@.....@.....@.....@.....@.....@.....@.....@.....@.....@.....@
@....@.....@.....@.....@.....@.....@.....@.....@.....@.....@.....@.....@.....@.....@.....@.....@.....@
@....@.....@.....@.....@.....@.....@.....@.....@.....@.....@.....@.....@.....@.....@.....@.....@.....@
@....@.....@.....@.....@.....@.....@.....@.....@.....@.....@.....@.....@.....@.....@.....@.....@.....@
@....@.....@.....@.....@.....@.....@.....@.....@.....@.....@.....@.....@.....@.....@.....@.....@.....@
@....................................................................................................@
@....................................................................................................@
@....................................................................................................@
@....................................................................................................@
@....................................................................................................@
@....................................................................................................@
@....................................................................................................@
@....................................................................................................@
@....................................................................................................@
@....................................................................................................@
@....................................................................................................@
@....................................................................................................@
@....................................................................................................@
@....................................................................................................@
@....................................................................................................@
@....................................................................................................@
@....................................................................................................@
@....................................................................................................@
@....................................................................................................@
@@@@@@@@@@@@@@@@@@@@@@@@@@@@@@@@@@@@@@@@@@@@@@@@@@@@@@@@@@@@@@@@@@@@@@@@@@@@@@@@@@@@@@@@@@@@@@@@@@@@@@
